Welcome, detective!  We really need your help in finding out who committed this terrible murder, where, and with what (the gun, knife, or poison).  I understand that you can accuse someone and determine if something is true about the accusation; that is a skill you'll need here!  But you'll need to hurry; we must find out who murdered Mr. David A. Wheeler right away.

Type "help" for more.

Accuse
A small replayable puzzle by David A. Wheeler
Release 4 / Serial number 070321 / Inform 7 build 4K41 (I6/v6.31 lib 6/11N) SD

Hall
You are in an elaborate formal hallway. Exits are east, south, and up.

You can see a gun here.

>e
Your boss says, "I'm so glad you've come.  Please hurry to determine who performed this murder, along with where and with what.  I know you have a special power when you accuse others; I've brought this note to explain it further."

He hands you a note.

Library
You're in a library covered wall-to-wall with computer books. There are exits west and down.

You can see Mr Thyme and a heavy chair (on which is your boss) here.

>actions
Actions listing on.

>say hello to boss
[answering your boss that "hello"]
There is no reply.
[answering your boss that "hello" - succeeded]

* * *

>e
Your boss says, "I'm so glad you've come.  Please hurry to determine who performed this murder, along with where and with what.  I know you have a special power when you accuse others; I've brought this note to explain it further."

He hands you a note.

Library
You're in a library covered wall-to-wall with computer books. There are exits west and down.

You can see Mr Thyme and a heavy chair (on which is your boss) here.

>say hi to boss
Your boss says, "Hurry up - we need to determine who performed this murder, along with where and with what.

* * *

>e
Your boss says, "I'm so glad you've come.  Please hurry to determine who performed this murder, along with where and with what.  I know you have a special power when you accuse others; I've brought this note to explain it further."

He hands you a note.

Library
You're in a library covered wall-to-wall with computer books. There are exits west and down.

You can see Mr Thyme and a heavy chair (on which is your boss) here.

>get chair
That's fixed in place.

* * *

>accuse salt rifle
"What!? Me, Mr Salt, with the rifle in the Hall?"

You sense that your accusation is COMPLETELY wrong.

>get rifle
Taken.

>up
Bedroom
You're in a plush bedroom; apparantly the owner liked creature comforts. The sole exit is down.

On the end table is a picture.

You can see a huge red button here.

>push button
Zap!  The world spins around you quickly.

Dungeon
You're in a dungeon.  Hmm, this isn't the normal kind of room you see in today's houses.  On the wall is written "Xyzzy isn't a magic word." The only way out of here is to go up.

>up
Your boss says, "I'm so glad you've come.  Please hurry to determine who performed this murder, along with where and with what.  I know you have a special power when you accuse others; I've brought this note to explain it further."

He hands you a note.

Library
You're in a library covered wall-to-wall with computer books. There are exits west and down.

You can see a heavy chair (on which is your boss) here.

>w
Hall
You can see Mr Thyme and Mr Salt here.

>s
Entrance
You're at the entrance to this grand estate, where a large red door to the outside.  I hope you aren't planning on leaving before you solve this mystery! The only way to go from here is north.

You can see a rusty knife, Ms Pepper and a brass plaque here.

>accuse pepper knife
"What!? Me, Ms Pepper, with the rusty knife in the Entrance?"

You sense that something about your accusation is true.

>get knife
Taken.

>n
Hall
You can see Mr Thyme and Mr Salt here.

>thyme, go up
Mr Thyme goes up.

>up
Bedroom
On the end table is a picture.

You can see Mr Thyme and a huge red button here.

>accuse thyme rifle
"What!? Me, Mr Thyme, with the rifle in the Bedroom?"

You sense that something about your accusation is true.

>d
Hall
You can see Mr Salt here.

>salt, go east
Mr Salt goes east.

>e
Library
You can see Mr Salt and a heavy chair (on which is your boss) here.

>accuse salt library
You can't see any such thing.

>accuse salt knife
"What!? Me, Mr Salt, with the rusty knife in the Library?"

You sense that something about your accusation is true.

>w
Hall

>s
Entrance
You can see Ms Pepper and a brass plaque here.

>accuse pepper rifle
"What!? Me, Ms Pepper, with the rifle in the Entrance?"

You sense that something about your accusation is true.

>n
Hall

>u
Bedroom
On the end table is a picture.

You can see Mr Thyme and a huge red button here.

>accuse thyme knife
"What!? Me, Mr Thyme, with the rusty knife in the Bedroom?"

You sense that something about your accusation is true.

>d
Hall

>e
Library
You can see Mr Salt and a heavy chair (on which is your boss) here.

>salt, go w
Mr Salt goes west.

>w
Hall
You can see Mr Salt here.

>salt, go s
The suspect argues with you for several minutes, instead of going anywhere.

>s
Entrance
You can see Ms Pepper and a brass plaque here.

>n
Hall
You can see Mr Salt here.

>salt, go s
Mr Salt goes south.

>s
Entrance
You can see Mr Salt, Ms Pepper and a brass plaque here.

>accuse salt knife
Pick on another weapon first!

>n
Hall

>u
A hollow voice says, "http://www.dwheeler.com".

Bedroom
On the end table is a picture.

You can see Mr Thyme and a huge red button here.

>accuse thyme knife
Pick on somebody else first!

>d
Hall

>s
Entrance
You can see Mr Salt, Ms Pepper and a brass plaque here.

>accuse pepper knife
Pick on another weapon first!

>accuse pepper rifle
"What!? Me, Ms Pepper, with the rifle in the Entrance?"

You sense that something about your accusation is true.

>pepper, go n
Ms Pepper goes north.

>n
Hall
You can see Ms Pepper here.

>accuse pepper knife
Pick on somebody else first!

>s
Entrance
You can see Mr Salt and a brass plaque here.

>salt, go n
Mr Salt goes north.

>n
Hall
You can see Mr Salt and Ms Pepper here.

>accuse pepper knife
Pick on somebody else first!

>accuse salt knife
"What!? Me, Mr Salt, with the rusty knife in the Hall?"

You sense that something about your accusation is true.

>give up
*** Sorry; the murder was committed by Ms Pepper using the rusty knife in the Bedroom.
 ***

Would you like to RESTART, RESTORE a saved game or QUIT?

* * *

>go d
You can't go that way.

>actions
Actions listing on.

>d
[going down]
You can't go that way.
[going down - failed the can't go that way rule]

>help
[helping]
Here are some useful commands:

north, south, east, west, up, and down: Go that direction.

Get (object): Get that object.

accuse (someone) with using (something): Accuse "someone" of committing the murder at this location, using "something".  You can omit the "with" and "using".

(Name), go (direction): Tell the named person to go that direction.

Give up: Give up, and be told what the solution was.
[helping - failed]

* * *

>d
You can't go that way.

>d
You can't go that way.

>d
There's no need to bump into walls, I'll tell you if there's an exit in a certain direction.

>e
Your boss says, "I'm so glad you've come.  Please hurry to determine who performed this murder, along with where and with what.  I know you have a special power when you accuse others; I've brought this note to explain it further."

He hands you a note.

Library
You're in a library covered wall-to-wall with computer books. There are exits west and down.

You can see a heavy chair (on which is your boss) here.

>d
Dungeon
You're in a dungeon.  Hmm, this isn't the normal kind of room you see in today's houses.  On the wall is written "Xyzzy isn't a magic word." The only way out of here is to go up.

You can see Mr Thyme and Ms Pepper here.

>up
Library
You can see a heavy chair (on which is your boss) here.

>w
Hall
You can see Mr Salt here.

>inv
You are carrying:
  a note

>inv
You are carrying:
  a note

>inv
You are carrying:
  a note

Are you having trouble? Type "help" to get more information.

>help
Your goal is to figure out who is the murderer, the murder weapon, and the murder location.  You can "accuse" someone of using something, and determine if there is something true or not about the location (i.e., if the suspect, weapon, or current location participated in the murder).

Here are some useful commands:

north, south, east, west, up, and down: Go that direction.

Get (object): Get that object.

accuse (someone) with using (something): Accuse "someone" of committing the murder at this location, using "something".  You can omit the "with" and "using".

(Name), go (direction): Tell the named person to go that direction.

Give up: Give up, and be told what the solution was.

* * *

>get poison
Taken.

>drop jar
Dropped.

>look
Hall
You are in an elaborate formal hallway. Exits are east, south, and up.

You can see a jar of poison here.

>get jar
Taken.

>s
Entrance
You're at the entrance to this grand estate, where a large red door to the outside.  I hope you aren't planning on leaving before you solve this mystery! The only way to go from here is north.

You can see a brass plaque here.

>n
Hall

>up
Bedroom
You're in a plush bedroom; apparantly the owner liked creature comforts. The sole exit is down.

On the end table is a picture.

You can see a gun, a rusty knife, Mr Salt and a huge red button here.

>get gun and knife
gun: Taken.
rusty knife: Taken.

>accuse salt knife
"What!? Me, Mr Salt, with the rusty knife in the Bedroom?"

You sense that something about your accusation is true.

>push button
Zap!  The world spins around you quickly.

Dungeon
You're in a dungeon.  Hmm, this isn't the normal kind of room you see in today's houses.  On the wall is written "Xyzzy isn't a magic word." The only way out of here is to go up.

You can see Mr Thyme here.

>accuse thyme gun
"What!? Me, Mr Thyme, with the gun in the Dungeon?"

You sense that your accusation is COMPLETELY wrong.

>up
Your boss says, "I'm so glad you've come.  Please hurry to determine who performed this murder, along with where and with what.  I know you have a special power when you accuse others; I've brought this note to explain it further."

He hands you a note.

Library
You're in a library covered wall-to-wall with computer books. There are exits west and down.

You can see Ms Pepper and a heavy chair (on which is your boss) here.

>accuse pepper gun
Pick on another weapon first!

>accuse pepper knife
"What!? Me, Ms Pepper, with the rusty knife in the Library?"

You sense that your accusation is COMPLETELY wrong.

>w
Hall

>up
Bedroom
On the end table is a picture.

You can see Mr Salt and a huge red button here.

>accuse salt point bedroom
You can't see any such thing.

>accuse salt poison
You solved it in only 52 minutes!

    *** You have won ***

Would you like to RESTART, RESTORE a saved game or QUIT?

>restart
Welcome, detective!  We really need your help in finding out who committed this terrible murder, where, and with what (either the knife or the rifle).  I understand that you can accuse someone and determine if something is true about it; that is a skill you'll need here!  But you'll need to hurry; we must find out who murdered Mr. David A. Wheeler right away.

Type "help" for more.

Accuse
A small replayable puzzle by David A. Wheeler
Release 2 / Serial number 070304 / Inform 7 build 4K41 (I6/v6.31 lib 6/11N) SD

Hall
You are in an elaborate formal hallway. Exits are east, south, and up.

You can see a rusty knife and Ms Pepper here.

>give up
*** Sorry; the murder was committed by Mr Thyme using the rusty knife in the Library.
 ***

Would you like to RESTART, RESTORE a saved game or QUIT?

>restart
Welcome, detective!  We really need your help in finding out who committed this terrible murder, where, and with what (either the knife or the rifle).  I understand that you can accuse someone and determine if something is true about it; that is a skill you'll need here!  But you'll need to hurry; we must find out who murdered Mr. David A. Wheeler right away.

Type "help" for more.

Accuse
A small replayable puzzle by David A. Wheeler
Release 2 / Serial number 070304 / Inform 7 build 4K41 (I6/v6.31 lib 6/11N) SD

Hall
You are in an elaborate formal hallway. Exits are east, south, and up.

>look
Hall
You are in an elaborate formal hallway. Exits are east, south, and up.

>s
Entrance
You're at the entrance to this grand estate, where a large red door to the outside.  I hope you aren't planning on leaving before you solve this mystery! The only way to go from here is north.

You can see a jar of poison, a gun and a brass plaque here.

>x door
You see nothing special about the big red door.

>x plaque
The plaque says, "This game Accuse is Copyright (C) 2007 David A. Wheeler. It is released under the terms of the GNU General Public License (GPL), version 2 or later.  That means you can modify this game and/or include it in other games, but you must release this game (modified or not, or included in a larger game) under the GNU GPL version 2 or later.  In particular, when you release it, you must release its source code too (so others can make their own improvements too!).  Please credit David A. Wheeler in any modified work."

* * *

>quit
*** Sorry; the murder was committed by Mr Salt using the gun in the Entrance.
 ***

Would you like to RESTART, RESTORE a saved game or QUIT?

>restart
Welcome, detective!  We really need your help in finding out who committed this terrible murder, where, and with what (the gun, knife, or poison).  I understand that you can accuse someone and determine if something is true about the accusation; that is a skill you'll need here!  But you'll need to hurry; we must find out who murdered Mr. David A. Wheeler right away.

Type "help" for more.

Accuse
A small replayable puzzle by David A. Wheeler
Release 3 / Serial number 070321 / Inform 7 build 4K41 (I6/v6.31 lib 6/11N) SD

Hall
You are in an elaborate formal hallway. Exits are east, south, and up.

You can see a rusty knife here.

>give up
*** Sorry; the murder was committed by Ms Pepper using the rusty knife in the Hall.
 ***

Would you like to RESTART, RESTORE a saved game or QUIT?

>restart
Welcome, detective!  We really need your help in finding out who committed this terrible murder, where, and with what (the gun, knife, or poison).  I understand that you can accuse someone and determine if something is true about the accusation; that is a skill you'll need here!  But you'll need to hurry; we must find out who murdered Mr. David A. Wheeler right away.

Type "help" for more.

Accuse
A small replayable puzzle by David A. Wheeler
Release 3 / Serial number 070321 / Inform 7 build 4K41 (I6/v6.31 lib 6/11N) SD

Hall
You are in an elaborate formal hallway. Exits are east, south, and up.

You can see a gun here.

* * *

>s
Entrance
You're at the entrance to this grand estate, where a large red door to the outside.  I hope you aren't planning on leaving before you solve this mystery! The only way to go from here is north.

You can see Mr Salt, Ms Pepper and a brass plaque here.

>get knife
Taken.

>n
Hall
You can see Mr Thyme and Ms Pepper here.

>accuse thyme knife
"What!? Me, Mr Thyme, with the rusty knife in the Hall?"

You sense that something about your accusation is true.

>up
Bedroom
You're in a plush bedroom; apparantly the owner liked creature comforts. The sole exit is down.

On the end table is a picture.

You can see a jar of poison and a huge red button here.

>get poison
Taken.

>push button
Zap!  The world spins around you quickly.

Dungeon
You're in a dungeon.  Hmm, this isn't the normal kind of room you see in today's houses.  On the wall is written "Xyzzy isn't a magic word." The only way out of here is to go up.

You can see Mr Salt here.

>accuse salt poison
"What!? Me, Mr Salt, with the jar of poison in the Dungeon?"

You sense that something about your accusation is true.

>up
Your boss says, "I'm so glad you've come.  Please hurry to determine who performed this murder, along with where and with what.  I know you have a special power when you accuse others; I've brought this note to explain it further."

He hands you a note.

Library
You're in a library covered wall-to-wall with computer books. There are exits west and down.

You can see a gun and a heavy chair (on which is your boss) here.

>get gun
Taken.

>w
Hall
You can see Mr Thyme and Ms Pepper here.

>accuse pepper gun
"What!? Me, Ms Pepper, with the gun in the Hall?"

You sense that something about your accusation is true.

>salt, go e
You seem to want to talk to someone, but I can't see whom.

>thyme, go e
Mr Thyme goes east.

>e
Library
You can see Mr Thyme and a heavy chair (on which is your boss) here.

>accuse thyme poison
"What!? Me, Mr Thyme, with the jar of poison in the Library?"

You sense that something about your accusation is true.

>w
Hall
You can see Ms Pepper here.

>accuse pepper gun
"What!? Me, Ms Pepper, with the gun in the Hall?"

You sense that something about your accusation is true.

>e
Library
You can see Mr Thyme and a heavy chair (on which is your boss) here.

>accuse thyme gun
Pick on another weapon first!

>accuse thyme knife
"What!? Me, Mr Thyme, with the rusty knife in the Library?"

You sense that your accusation is COMPLETELY wrong.

>w
Hall
You can see Ms Pepper here.

>accuse pepper poison
"What!? Me, Ms Pepper, with the jar of poison in the Hall?"

You sense that something about your accusation is true.

>e
Library
You can see Mr Thyme and a heavy chair (on which is your boss) here.

>accuse thyme knife
"What!? Me, Mr Thyme, with the rusty knife in the Library?"

You sense that your accusation is COMPLETELY wrong.

* * *

>w
Hall
You can see Ms Pepper here.

>u
Bedroom
On the end table is a picture.

You can see a huge red button here.

>d
Hall
You can see Ms Pepper here.

>u
Bedroom
On the end table is a picture.

You can see a huge red button here.

>push button
Zap!  The world spins around you quickly.

Dungeon
You're in a dungeon.  Hmm, this isn't the normal kind of room you see in today's houses.  On the wall is written "Xyzzy isn't a magic word." The only way out of here is to go up.

You can see Mr Salt here.

>salt, go u
Mr Salt goes up.

>u
Library
You can see Mr Salt, Mr Thyme and a heavy chair (on which is your boss) here.

>salt, g w
To repeat a command like "frog, jump", just say "again", not "frog, again".

>salt, go w
Mr Salt goes west.

>w
Hall
You can see Mr Salt and Ms Pepper here.

>accuse salt poison
You solved it in only 114 minutes!

    *** You have won ***

Would you like to RESTART, RESTORE a saved game or QUIT?

* * *

>s
Entrance
You're at the entrance to this grand estate, where a large red door to the outside.  I hope you aren't planning on leaving before you solve this mystery! The only way to go from here is north.

You can see Mr Salt, Ms Pepper and a brass plaque here.

>n
Hall

>u
Bedroom
You're in a plush bedroom; apparantly the owner liked creature comforts. The sole exit is down.

On the end table is a picture.

You can see a jar of poison, a rusty knife and a huge red button here.

>get poison
Taken.

>get knife
Taken.

>x poison
It's a jar of poison.  You know this, because it says "POISON" in big letters on the side of the jar.  Below it is the tagline, "Guaranteed to kill quickly, and there's no antidote!".  Who sells this stuff?!?

>x knife
It's a knife with a rusty handle.  The blade, however, has been recently sharpened and cleaned.

>get knife
You already have that.

>look
Bedroom
You're in a plush bedroom; apparantly the owner liked creature comforts. The sole exit is down.

On the end table is a picture.

You can see a huge red button here.

>x picture
You see a picture of the very handsome David A. Wheeler, former maintainer of Scepter of Goth, who coincidentally is the author of this game.  Yup, he's very handsome.

>x button
It's a big, blinking red button, in the middle of the wall.

>push button
Zap!  The world spins around you quickly.

Dungeon
You're in a dungeon.  Hmm, this isn't the normal kind of room you see in today's houses.  On the wall is written "Xyzzy isn't a magic word." The only way out of here is to go up.

You can see a gun and Mr Thyme here.

>xyzzy
Nothing happens.

>x gun
It's a 9mm, with some bullets left.

>get gun
Taken.

>x thume
You can't see any such thing.

>x thyme
Mr Thyme is wearing a shabby overcoat, and shifting his eyes rapidly from place to place.

>up
Your boss says, "I'm so glad you've come.  Please hurry to determine who performed this murder, along with where and with what.  I know you have a special power when you accuse others; I've brought this note to explain it further."

He hands you a note.

Library
You're in a library covered wall-to-wall with computer books. There are exits west and down.

You can see a heavy chair (on which is your boss) here.

>x boss
Your boss is a plump, short man; the buttons on his shirt are straining to escape.

>read note
The note says, "Sir, we've done all sorts of tests, and you have an extraordinary gift.  By merely accusing someone of using something for murder, you can determine there is something true about the accusation with complete accuracy.  There are some complications, though.  For example, the weapon and your current location are considered part of the accuration... so if you accuse an innocent person in the murder location or of using the murder weapon, you'll only determine that something in your accusation is true. For each accusation you have to use a completely different set of people, weapon, and location than your previous accusation; this can complicate your efforts.  Also, it takes 10 minutes for you to determine if an accusation is true... that may be a problem when you are in a hurry.  Science is completely unable to explain your gift; use it wisely."

>x chair
You see nothing special about the heavy chair.

>x books
There's no time for that.  There's a murder to be solved here.

>w
Hall

>s
Entrance
You can see Mr Salt, Ms Pepper and a brass plaque here.

>x salt
Mr Salt is tall, thin, and worried.

>x pepper
Ms Pepper is a pretty woman with a great smile.  She's wearing a T-shirt and blue jeans.

>give up
*** Sorry; the murder was committed by Mr Salt using the gun in the Library.
 ***

Would you like to RESTART, RESTORE a saved game or QUIT?

>restart
Welcome, detective!  We really need your help in finding out who committed this terrible murder, where, and with what (the gun, knife, or poison).  I understand that you can accuse someone and determine if something is true about it; that is a skill you'll need here!  But you'll need to hurry; we must find out who murdered Mr. David A. Wheeler right away.

Type "help" for more.

Accuse
A small replayable puzzle by David A. Wheeler
Release 3 / Serial number 070304 / Inform 7 build 4K41 (I6/v6.31 lib 6/11N) SD

Hall
You are in an elaborate formal hallway. Exits are east, south, and up.

You can see Mr Salt here.

>please say hello
(Quelle politesse! But no need to say please.)

(to Mr Salt)
There is no reply.

* * *

>get gun
Taken.

>looik
That's not a verb I recognise.

>look
Hall
You are in an elaborate formal hallway. Exits are east, south, and up.

>s
Entrance
You're at the entrance to this grand estate, where a large red door to the outside.  I hope you aren't planning on leaving before you solve this mystery! The only way to go from here is north.

You can see Mr Salt and a brass plaque here.

>accuse salt gun
"What!? Me, Mr Salt, with the gun in the Entrance?"

You sense that something about your accusation is true.

>n
Hall

>up
Bedroom
You're in a plush bedroom; apparantly the owner liked creature comforts. The sole exit is down.

On the end table is a picture.

You can see a jar of poison, Ms Pepper and a huge red button here.

>get poison
Taken.

>accuse pepper poison
"What!? Me, Ms Pepper, with the jar of poison in the Bedroom?"

You sense that something about your accusation is true.

>push button
Zap!  The world spins around you quickly.

Dungeon
You're in a dungeon.  Hmm, this isn't the normal kind of room you see in today's houses.  On the wall is written "Xyzzy isn't a magic word." The only way out of here is to go up.

You can see Mr Thyme here.

* * *

>accuse thyme gun
"What!? Me, Mr Thyme, with the gun in the Dungeon?"

You sense that your accusation is COMPLETELY wrong.

>up
Your boss says, "I'm so glad you've come.  Please hurry to determine who performed this murder, along with where and with what.  I know you have a special power when you accuse others; I've brought this note to explain it further."

He hands you a note.

Library
You're in a library covered wall-to-wall with computer books. There are exits west and down.

You can see a rusty knife and a heavy chair (on which is your boss) here.

>get knife
Taken.

>w
Hall

>up
Bedroom
On the end table is a picture.

You can see Ms Pepper and a huge red button here.

>accuse pepper poison
"What!? Me, Ms Pepper, with the jar of poison in the Bedroom?"

You sense that something about your accusation is true.

>d
Hall

>s
Entrance
You can see Mr Salt and a brass plaque here.

>accuse salt knife
"What!? Me, Mr Salt, with the rusty knife in the Entrance?"

You sense that something about your accusation is true.

>n
Hall

>e
Library
You can see a heavy chair (on which is your boss) here.

>d
Dungeon
You can see Mr Thyme here.

>accuse thyme poison
"What!? Me, Mr Thyme, with the jar of poison in the Dungeon?"

You sense that something about your accusation is true.

>up
Library
You can see a heavy chair (on which is your boss) here.

I beg your pardon?

>w
Hall

>s
Entrance
You can see Mr Salt and a brass plaque here.

>accuse salt poison
Pick on another weapon first!

>n
Hall

>u
Bedroom
On the end table is a picture.

You can see Ms Pepper and a huge red button here.

>accuse pepper gun
"What!? Me, Ms Pepper, with the gun in the Bedroom?"

You sense that something about your accusation is true.

>d
Hall

* * *

>salt, go n
Mr Salt goes north.

>n
Hall
You can see Mr Salt here.

>accuse salt knife
"What!? Me, Mr Salt, with the rusty knife in the Hall?"

You sense that your accusation is COMPLETELY wrong.

>up
A hollow voice says, "http://www.dwheeler.com".

Bedroom
On the end table is a picture.

You can see Ms Pepper and a huge red button here.

>pepper, go d
Ms Pepper goes down.

>d
Hall
You can see Ms Pepper and Mr Salt here.

>pepper, go s
Ms Pepper goes south.

>s
Entrance
You can see Ms Pepper and a brass plaque here.

>accuse pepper poison
You solved it in 120 minutes!

    *** You have won ***

Would you like to RESTART, RESTORE a saved game or QUIT?

>restart
Welcome, detective!  We really need your help in finding out who committed this terrible murder, where, and with what (the gun, knife, or poison).  I understand that you can accuse someone and determine if something is true about it; that is a skill you'll need here!  But you'll need to hurry; we must find out who murdered Mr. David A. Wheeler right away.

Type "help" for more.

Accuse
A small replayable puzzle by David A. Wheeler
Release 3 / Serial number 070304 / Inform 7 build 4K41 (I6/v6.31 lib 6/11N) SD

Hall
You are in an elaborate formal hallway. Exits are east, south, and up.

You can see a jar of poison, a rusty knife and Mr Thyme here.

>thyme, go e
Mr Thyme goes east.

>follow
That's not a verb I recognise.

>help
Your goal is to figure out who is the murderer, the murder weapon, and the murder location.  You can "accuse" someone of using something, and determine if there is something true or not about the location (i.e., if the suspect, weapon, or current location participated in the murder).

Here are some useful commands:

north, south, east, west, up, and down: Go that direction.

Get (object): Get that object.

accuse (someone) with using (something): Accuse "someone" of committing the murder at this location, using "something".  You can omit the "with" and "using".

(Name), go (direction): Tell the named person to go that direction.

Give up: Give up, and be told what the solution was.

* * *

>accuse pepper
What do you want to accuse Ms Pepper?

>gun
"What!? Me, Ms Pepper, with the gun in the Hall?"

You sense that your accusation is COMPLETELY wrong.

* * *

>x knife
It's a knife with a rusty handle.  The blade, however, has been recently sharpened and cleaned.

>get knife
Taken.

>help
Your goal is to figure out the murderer, murder weapon, and murder location.  You can "accuse" someone of using something, and determine if there is something true or not about the accusation (i.e., if the suspect, weapon, or current location participated in the murder).

Here are some useful commands:

north, south, east, west, up, and down: Go that direction.

Get (object): Get that object.

accuse (someone) with using (something): Accuse "someone" of committing the murder at this location, using "something".  You can omit the "with" and "using".

(Name), go (direction): Tell the named person to go that direction.

Give up: Give up, and be told what the solution was.

>s
Entrance
You're at the entrance to this grand estate, where a large red door to the outside.  I hope you aren't planning on leaving before you solve this mystery! The only way to go from here is north.

You can see a brass plaque here.

* * *

>n
Hall

>up
Bedroom
You're in a plush bedroom; apparantly the owner liked creature comforts. The sole exit is down.

On the end table is a picture.

You can see a gun, Mr Thyme, Ms Pepper and a huge red button here.

>accuse pepper gun
"What!? Me, Ms Pepper, with the gun in the Bedroom?"

You sense that something about your accusation is true.

* * *

>d
Hall

>e
Your boss says, "I'm so glad you've come.  Please hurry to determine who performed this murder, along with where and with what.  I know you have a special power when you accuse others; I've brought this note to explain it further."

He hands you a note.

Library
You're in a library covered wall-to-wall with computer books. There are exits west and down.

You can see Mr Salt and a heavy chair (on which is your boss) here.

>accuse salt fred
You can't see any such thing.

>inv
You are carrying:
  a note
  a rusty knife

>accuse salt gun
You can't see any such thing.

>read note
The note says, "Sir, we've done all sorts of tests, and you have an extraordinary gift.  By merely accusing someone of using something for murder, you can determine if there is something true about the accusation with complete accuracy.  There are some complications, though.  For example, the weapon and your current location are considered part of the accuration... so if you accuse an innocent person in the murder location or of using the murder weapon, you'll only determine that something about your accusation is true. For each accusation you have to use a completely different set of people, weapon, and location than your previous accusation; this can complicate your efforts.  Also, it takes 10 minutes for you to determine if an accusation is true... that may be a problem when you are in a hurry.  Science is completely unable to explain your gift; use it wisely."

>quit
Are you sure you want to quit?

* * *

>actions
Actions listing on.

>rules
Rules tracing now switched on. Type "rules off" to switch it off again, or "rules all" to include even rules which do not apply.

>quit
[quitting the game]
    [Rule "Check quitting the game" applies.]
Checking.

    [Rule "Carry out quitting the game" applies.]
[quitting the game - succeeded]

    *** Sorry; the murder was committed by Mr Thyme using the gun in the Bedroom.
 ***

Would you like to RESTART, RESTORE a saved game or QUIT?

>restore
Restore failed.

Would you like to RESTART, RESTORE a saved game or QUIT?

>restart
Welcome, detective!  We really need your help in finding out who committed this terrible murder, where, and with what (the gun, knife, or poison).  I understand that you can accuse someone and determine if something is true about the accusation; that is a skill you'll need here!  But you'll need to hurry; we must find out who murdered Mr. David A. Wheeler right away.

Type "help" for more.

Accuse
A small replayable puzzle by David A. Wheeler
Release 3 / Serial number 070321 / Inform 7 build 4K41 (I6/v6.31 lib 6/11N) SD

Hall
You are in an elaborate formal hallway. Exits are east, south, and up.

* * *

>rules
Rules tracing now switched on. Type "rules off" to switch it off again, or "rules all" to include even rules which do not apply.

>inv
[taking inventory]
You are carrying nothing.

[taking inventory - succeeded]

>inv
[taking inventory]
You are carrying nothing.

[taking inventory - succeeded]

>inv
[taking inventory]
You are carrying nothing.

    [Rule "After acting confused for the sixth turn" applies.]
Are you having trouble? Type "help" to get more information.
[taking inventory - succeeded]

>inv
[taking inventory]
You are carrying nothing.

[taking inventory - succeeded]

>w
[going west]
You can't go that way.
[going west - failed the can't go that way rule]

>w
[going west]
You can't go that way.
[going west - failed the can't go that way rule]

>w
[going west]
    [Rule "Instead of going nowhere for the third time" applies.]
There's no need to bump into walls, I'll tell you if there's an exit in a certain direction.
[going west - failed]

>w
[going west]
You can't go that way.
[going west - failed the can't go that way rule]

* * *

>rules
Rules tracing now switched on. Type "rules off" to switch it off again, or "rules all" to include even rules which do not apply.

>w
[going west]
You can't go that way.
[going west - failed the can't go that way rule]

>asdf
That's not a verb I recognise.

* * *

>w
You can't go that way.

>w
You can't go that way.

>w
There's no need to bump into walls, I'll tell you if there's an exit in a certain direction.

You can't go that way.

>w
You can't go that way.

* * *

>get all
(the gun)
Taken.

>s
Entrance
You're at the entrance to this grand estate, where a large red door to the outside.  I hope you aren't planning on leaving before you solve this mystery! The only way to go from here is north.

You can see a jar of poison and a brass plaque here.

>get all
jar of poison: Taken.
brass plaque: That's fixed in place.

>n
Hall

>up
Bedroom
You're in a plush bedroom; apparantly the owner liked creature comforts. The sole exit is down.

On the end table is a picture.

You can see a rusty knife, Mr Thyme, Ms Pepper and a huge red button here.

>get all
rusty knife: Taken.
Mr Thyme: I don't suppose Mr Thyme would care for that.
Ms Pepper: I don't suppose Ms Pepper would care for that.
huge red button: That's fixed in place.
picture: Taken.

>accuse thyme knife
"What!? Me, Mr Thyme, with the rusty knife in the Bedroom?"

You sense that something about your accusation is true.

>quit
*** Sorry; the murder was committed by Mr Salt using the rusty knife in the Hall.
 ***

Would you like to RESTART, RESTORE a saved game or QUIT?